Humans: 200
RRRRRRRRRRRRRRRRRRRRRRRRRRRRRRRRRRRRRRRRRRRRRRRRRRRRRRRRRRRRRRRRRRRRRRRRRRRRRRRRRRRRRRRRRRRRRRRRRRRRRRRRRRRRRRRR
RFFFFFFFFFFFFFFFFFFFFFFFFFFFFFFFFFFFFFFFFFFFFFFFFFFFFFFFFFFFFFFFFFFFFFFFFFFFFFFFFFFFFFFFFFFFFFFFFFFFFFFFFFFFFFFR
RFFFFFFFFFFFFFFFFFFFFFFFFFFFFFFFFFFFFFFFFFFFFFFFFFFFFFFFFFFFFFFFFFFFFFFFFFFFFFFFFFFFFFFFFFFFFFFFFFFFFFFFFFFFFFFR
RFFFFFFFFFFFFFFFFFFFFFFFFFFFFFFFFFFFFFFFFFFFZFFFFFFFFFFFFFFFFFFFFFFFFFFFFFFFFFFFFFFFFFFFFFFFFFFFFFFFFFFFFFFFFFFR
RFFFFFFFFFFFFFFFFFFFFFFFFFFFFFFFFFFFFFFFFFFFFFFFFFFFFFFFFFFFFFFFFFFFFFFFFFFFFFFFFFFFFFFFFFFFFFFFFFFFFFFFFFFFFFFR
RFFFFFFFFFFFRRRGRGRRRFWWWFRRRRRGGRRRRRFFFFFFFFFFFFFFFFFLGGLBBBBLGGLBBBBLGGLFFFFFFFFFFFFFFFFFFFFFFFFFFFFFFFFFFFFR
RFFFFFFFFFFFR.......RFWWWFG..........LFFFFFFFFFFFFFFFFFL....B........B....LFFFFFFFFBBBGBBGBBGBB.BBGBBGBBGBBBFFFR
RFFFFFFFFFFFR.......LFWWWFL...........FFFFFFFFFFFFFFFFFG....B........B....GFFFFFFFFB......B.........B......BFFFR
RFFFFFFFFFFFR........FWWWF...........LFFFFFFFFFFFFFFFFFB....B........B....BFFFFFFFFBBBBBB.............BBBBBBFFFR
RFFFFFFFFFFFR.......LFWWWFL.....RRRRRRFFFFFFFFFFFFFFFFF.....B........B.....FFFFFFFFL.......................LFFFR
RFFFFFFFFFFFRRRGRGRRRFWWWFG..........RFFFFFFFFFFFFFFFFFB....BBBL..LBBB....BFFFFFFFF.........................FFFR
RFFFFFFFFFFFFFFFFFFFFFFFFFRRRRRGGRRRRRFFFFFFFFFFFFFFFFFG..................GFFFFFFFF.........................FFFR
RFFFFFFFFFFFFFFFFFFFFFFFFFFFFFFFFFFFFFFFFFFFFFFFFFFFFFFL..................LFFFFFFFFL.......................LFFFR
RFFFFFFFFFFFWWWWWWWWWWWWWWWWWWWWWWWWWWWWWWWWWWWWWFFFFFFLGGLBBBBL..LBBBBLGGLFFFFFFFFB.......................BFFFR
RFFFFFFFFFFFWWWWWWWWWWWWWWWWWWWWWWWWWWWWWWWWWWWWWFFFFFFFFFFFFFFFFFFFFFFFFFFFFFFFFFFB.......................BFFFR
RFFFFFFFFFFFWWWWWWWWWWWWWWWWWWWWWWWWWWWWWWWWWWWWWFFFFFFFFFFFFFFFFFFFFFFFFFFFFFFFFFFBBBGBBGBBGBB.BBGBBGBBGBBBFFFR
RFFFFFFFFFFFFFFFFFFFFFFFFFFFFFFFFFFFFFFFFFFFFFFFFFFFFFFFFFFFFFFFFFFFFFFFFFFFFFFFFFFFFFFFFFFFFFFFFFFFFFFFFFFFFFFR
RFFFFFFFFFFFFFFFFFFFFFFFFFFFFFFFFFFFFFFFFFFFFFFFFFFFFFFFFFFFFFFFFBBGGBL..LBGGBBFFFFFFFFFFFFFFFFFFFFFFFFFFFFFFFFR
RFFFFFFFFFFLLLLLGGGLLLLLLLLLLLLGGGLLLLLFFFFFFBGBBGBFFFFFFFFFFFFFFB............BFFFFFFFFFFFFFFFFFFFFFFFZFFFFFFFFR
RFFFFFFFFFFL.............L............LFFFFFFB....BFFFFFFFFFFFFFFB............BFFFFFFFFFFFFFFFFFFFFFFFFFFFFFFFFR
RFFFFFFFFFFG.............L............GFFFFFFB....GFFFFFFFFFFFFFFL............LFFFFFFFFFFFFFFFFFFFFFFFFFFFFFFFFR
RFFFFFFFFFFLLLLLLL.LLLLLLLLLLLLL.LLLLLLFFFFFF.....GFFFFFFFFFFFFFF......@.......FFFFFFFFFFFFFFFFFFFFFFFFFFFFFFFFR
RFFFFFFFFFFFFFFFFFFFFFFFFFFFFFFFFFFFFFFFFFFFFB....BFFFFFFFFFFFFFFL............LFFFFFFFFFFFFFFFFFFFFFFFFFFFFFFFFR
RFFFFFFFFFFFFFFFFFFFFFFFFFFFFFFFFFFFFFFFFFFFFBGBBGBFFFFFFFFFFFFFFB............BFFFFFFFFFFFFFFFFFFFFFFFFFFFFFFFFR
RFFFFFFFFFFLLLL.LLLLLLLLL.LLLLLLLL.LLLLFFFFFFFFFFFFFFFFFFFFFFFFFFB............BFFFFFFFFFFFFLLB.BLLFFFWWWWWWWFFFR
RFFFFFFFFFFG.......L..........L.......GFFFFFFFFFFFFFFFFFFFFFFFFFFBBGGBL..LBGGBBFFFFFFFFFFFFB.....BFFFWWWWWWWFFFR
RFFFFFFFFFFL.......L..........L.......LFFFFFFFFFFFFFFFFFFFFFFFFFFFFFFFFFFFFFFFFFFFFFFFFFFFF......BFFFWWWWWWWFFFR
RFFFFFFFFFFLLLL.LLLLLLLLL.LLLLLLLL.LLLLFFFFFFRRR.RRRFFFFFFFFFFFFFFFFFFFFFFFFFFFFFFFFFFFFFFFB......FFFWWWWWWWFFFR
RFFFFFFFFFFFFFFFFFFFFFFFFFFFFFFFFFFFFFFFFFFFFR.....RFFFFFFFFFFFFFFFFFFFFFFFFFFFFFFFFFFFFFFFB.....BFFFWWWWWWWFFFR
RFFFFFFFFFFFFFFFFFFFFFFFFFFFFFFFFFFFFFFFFFFFFR.....RFFZFFFFFFFFFFFFFFFFFFFFFFFFFFFFFFFFFFFFLLGGGLLFFFWWWWWWWFFFR
RFFFFFFFFFFFFFFFFFFFFFFFFFFFFFFFFFFFFFFFFFFFFRFFFFFRFFFFFFFFFFFFFFFFFFFFFFFFFFFFFFFFFFFFFFFFFFFFFFFFFFFFFFFFFFFR
RRRRRRRRRRRRRRRRRRRRRRRRRRRRRRRRRRRRRRRRRRRRRRRRRRRRRRRRRRRRRRRRRRRRRRRRRRRRRRRRRRRRRRRRRRRRRRRRRRRRRRRRRRRRRRRR